[
  "0*0*0*0*0*0*0*0*0*0*0*0*0*0*0*0*0*0*0*0*",
  "0* . . . . . . . . . . . . . . . . . .0*",
  "0* . . . . . . . . . . . . . . . . . .0*",
  "0* . . . . . . . . . .K*G*H*I*J* . . .0*",
  "0* . . . . . . . . . .G. . . . . . . .0*",
  "0* . . . . . . . . . . . . . . . . . .0*",
  "0*C*D*E*F* . . . .Q. .Q. . . . . . . .0*",
  "0* . . . .E. . . . . . . .D. . . .K. .0*",
  "0*3*2*3*2*4* . . . . . . .A*V*V*V*R* .0*",
  "0* . . . . .Q. . .7.7. . .Q. . . . . .0*",
  "0*N.E.N.E. . . .L*M*N*O* . .E.N.E.N. .0*",
  "0*2*3*2*3*4* . . . . . . . .1*2*3*2*3*0*",
  "0* . . .A. . . . . . . .D. . . . . . .0*",
  "0* . . .B. . . .7.7.7. . .F. . .8. . .0*",
  "0*0*0*0*0*0*0*0*0*0*0*0*0*0*0*0*0*0*0*0*"
]
