[
  "0*0*0*0*0*0*0*0*0*0*0*0*0*0*0*0*0*0*0*0*",
  "0* . . . . . . . . . . . . . . . . . .0*",
  "0* . . . . . . . . . . . . . . . . . .0*",
  "0* . . . . . . . . . . . . . . . . . .0*",
  "0* . . . . . . . . . . . . . . . . . .0*",
  "0* . . . . . . . . . . . . . . . . . .0*",
  "0* . . . . . . .K*H*I*J* . . . . . . .0*",
  "0* .K.N. . . . . . . . . . . . .K. . .0*",
  "0*3*2*3*2*4* . . . . . . . .1*3*2*3*2*0*",
  "0* . . . . . . .Q.7.7.Q. . . . . . . .0*",
  "0*N.E.N.E. . . .L*M*N*O* . . .E.N.E.N.0*",
  "0*2*3*2*3*4* . . . . . . . .1*2*3*2*3*0*",
  "0* . . . . . . . . . . . . . . . . . .0*",
  "0* . . . . .7.7.7. . . . . .8. . . . .0*",
  "0*0*0*0*0*0*0*0*0*0*0*0*0*0*0*0*0*0*0*0*"
]
